deutsche_verben:
----------------

sein: ich bin, du bist, es ist, wir sind, ihr seid, sie sind
haben: ich habe, du hast, es hat, wir haben, ihr habt, sie haben
tun: ich tue, du tust, es tut, wir tun, ihr tut, wir tun
-können: ich kann, du kannst, es kannt, wir können, ihr könnt, sie können
machen: ich mache, du machst, es macht, wir machen, ihr macht, sie machen
werden: ich werde, du wirst, es wird, wir werden, ihr werdet, sie werden
wissen: ich weiß, du weißt, es weiß, wir wissen, ihr wisst, sie wissen

kommen: ich komme, du kommst, es kommt, wir kommen, ihr kommt, sie kommen
-mögen: ich mag, du magst, es mag, wir mögen, ihr mögt, sie mögen
möchten: ich möchte, du möchst, es möcht, wir möchten, ihr möchtet, sie möchten
*sehen: ich sehe, du siehst, es sieht, wir sehen, ihr seht, sie sehen
verstehen: ich verstehe, du verstehst es versteht, wir verstehen, ihr versteht, sie verstehen
kosten: ich koste, du kostest, es kostet, wir kosten, ihr kostet, sie kosten
kaufen: ich kaufe, du kaufst, es kauft, wir kaufen, ihr kauft, sie kaufen
zahlen: ich zahle, du zahlst, es zahlt, wir zahlen, ihr zahlt, sie zahlen
lieben: ich liebe, du liebst, es liebt, wir lieben, ihr liebt, sie lieben
*geben: ich gebe, du gibst, es gibt, wir geben, ihr gebt, sie geben


suchen: ich suche, du suchst, es sucht, wir suchen, ihr sucht, sie suchen
+heißen: ich heiße, du heißt, es heißt, wir heißen, ihr heißt, sie heißen
leben: ich lebe, du lebst, es lebt, wir leben, ihr lebt, sie leben

*sprechen: ich spreche, du sprichst, es spricht, wir sprechen, ihr sprecht, sie sprechen
schreiben: ich schreibe, du schreibst, es schreibt, wir schreiben, ihr schreibt, sie schreiben
+lesen: ich lese, du liest, es liest, wir lesen, ihr lest, sie lesen
hören: ich höre, du hörst, es hört, wir hören, ihr hört, sie hören
sagen: ich sage, du sagst, es sagt, wir sagen, ihr sagt, sie sagen
denken: ich denke, du denkst, es denkt, wir denken, ihr denkt, sie denken
glauben: ich glaube, du glaubst, es glaubt, wir glauben, ihr glaubt, sie glauben
erklären: ich erkläre, du erklärst, es erklärt, wir erklären, ihr erklärt, sie erklären



Hobbys:
kochen: ich koche, du kochst, es kocht, wir kochen, ihr kocht, sie kochen
spielen: ich spiele, du spielts, es spielt, wir spielen, ihr spielt, sie spielen
schwimmen: ich schwimme, du schwimmst, es schwimmt, wir schwimmen, ihr schwimmt, sie schwimmen
malen: ich male, du malst, es malt, wir malen, ihr malt, sie malen
wandern: ich wandere, du wanderst, es wandert, wir wandern, ihr wandert, sie wandern
+reisen: ich reise, du reist, es reist, wir reisen, ihr reist, sie reisen
gehen: ich gehe, du gehst, es geht, wir gehen, ihr geht, sie gehen
singen: ich singe, du singst, es singt, wir singen, ihr singt, sie singen
fotografieren: ich fotografiere, du fotografierst, es fotografiert, wir fotografieren, ihr fotografiert, sie fotografieren
tanzen: ich tanze, du tanzt, es tanzt, wir tanzen, ihr tanzt, sie tanzen
surfen: ich surfe, du surfst, es surft, wir surfen, ihr surft, sie surfen



arbeiten: ich arbeite, du arbeitest, es arbeitet, wir arbeiten, ihr arbeitet, sie arbeiten
lernen: ich lerne, du lernst, es lernt, wir lernen, ihr lernt, sie lernen
+essen: ich esse, du isst, es isst, wir essen, ihr esst, sie essen
trinken: ich trinke, du trinkst, es trinkt, wir trinken, ihr trinkt, sie trinken
frühstücken: ich frühstücke, du frühstückst, es frühstückt, wir frühstücken, ihr frühstückt, sie frühstücken
*helfen: ich helfe, du hilfst, es hilft, wir helfen, ihr helft, sie helfen
*nehmen: ich nehme, du nimmst, es nimmt, wir nehmen, ihr nehmt, sie nehmen
brauchen: ich brauche, du brauchst, es braucht, wir brauchen, ihr braucht, sie brauchen
*schlafen: ich schlafe, du schläfst, es schläft, wir schlafen, ihr schlaft, sie schlafen
+passen: ich passe, du passt, es passt, wir passen, ihr passt, sie passen
bestellen: ich bestelle, du bestellst, es bestellt, wir bestellen, ihr bestellt, sie bestellen
besuchen: ich besuche, du besuchst, es besucht, wir besuchen, ihr besucht, sie besuchen





*fahren: ich fahre, du fährst, es fährt, wir fahren, ihr fahrt, sie fahren
fliegen: ich fliege, du fliegst, es fliegt, wir fliegen, ihr fliegt, sie fliegen
*laufen: ich laufe, du läufst, es läuft, wir laufen, ihr lauft, sie laufen
spazieren: ich spaziere, du spazierst, es spaziert, wir spazieren, ihr spaziert, sie spazieren
*fallen: ich falle, du fällst, es fällt, wir fallen, ihr fallt, sie fallen


öffnen: ich öffne, du öffst. es öfft, wir öffnen, ihr öfft, sie öffnen
schließen: ich schließe, du schließt, es schließt, wir schließen, ihr schließt, sie schließen
stornieren: ich storniere, du stornierst, es storniert, wir stornieren, ihr storniert, sie stornieren
wiederholen: ich wiederhole, du wiederholst, es wiederholt, wir wiederholen, ihr wiederholt, sie wiederholen
warten: ich warte, du wartest, es wartet, wir warten, ihr wartet, sie warten
dauern: ich dauere, du dauerst, es dauert, wir dauern, ihr dauert, sie dauern

schreien: ich schreie, du schreist, es schreit, wir schreien, ihr schreit, sie schreien
weinen: ich weine, du weinst, es weint, wir weinen, ihr weint, sie weinen
lachen: ich lache, du lachst, es lacht, wir lachen, ihr lacht, sie lachen
schweigen: ich schweige, du schweigst, es schweigt, wir schweigen, ihr schweigt, sie schweigen

feiern: ich feiere, du feierst, es feiert, wir feiern, ihr feiert, sie feiern





für das Wetter:
regnen: es regnet
schneien: es schneit


"to use":
- für einen bestimmten Zweck:
verwenden: ich verwende, du verwendest, es verwendet, wir verwenden, ihr verwendet, sie verwenden

- für profitieren:
nützen: ich nütze, du nützt, es nützt, wir nützen, ihr nützt, sie nützen

- für einen allgemeinen Zweck:
nutzen: ich nutze, du nutzt, es nutzt, wir nutzen, ihr nutzt, sie nutzen







# die Konjugation:
## Präsens/Gegenwart: Standard
Ich spiele, du gehst


## Päteritum/Imperfekt: -te/-ten
-starke Verben:
sein/waren: ich war, du warst, es war, wir waren, ihr wart, sie waren
gehen/gingen: ich ging, du gingst, es ging, wir gingen, ihr gingt, sie gingen
wissen/wussten: ich wusste, du wusstest, es wusste, wir wussten, ihr wusstet, sie wussten

-schwache Verben:
haben/hatten: ich hatte, du hattest, es hatte, wir hatten, ihr hattet, sie hatten
spielen/spielten: ich spielte, du spieltest, es spielte, wir spielten, ihr spieltet, sie spielten
können/konnten: ich konnte, du konntest, es konnte, wir konnten, ihr konntet, sie konnten
machen/machten: ich machte, du machtest, es machte, wir machten, ihr machtet, sie machten
wollen/wollten: ich wollte, du wolltest, es wollte, wir wollten, ihr wolltet, sie wollten
sollen/sollten: ich sollte, du solltest, es sollte, wir sollten, ihr solltet, sie sollten
müssen/mussten: ich musste, du musstest, es musste, wir mussten, ihr musstet, sie mussten



## Partizip I (present continous): -end/-nd       [nutz oft nicht]
Ich bin spielend, du bist gehend


## Partizip II (past participle): ge- -t/-en
Ich habe gespielt, du hast gegangen


